//MAP CONVERTED BY dmm2tgm.py THIS HEADER COMMENT PREVENTS RECONVERSION, DO NOT REMOVE
"A" = (
/obj/effect/landmark/start/basicOrk,
/turf/simulated/floor,
/area/vault/warhammergen/orkspawn)
"B" = (
/turf/simulated/wall/r_wall,
/area/vault/warhammergen/orkspawn)
"E" = (
/turf/space,
/area)
"R" = (
/turf/simulated/floor,
/area/vault/warhammergen/orkspawn)

(1,1,1) = {"
E
E
E
E
E
E
E
E
E
E
E
E
E
E
E
E
E
E
E
E
"}
(2,1,1) = {"
E
E
E
E
E
E
B
B
B
B
R
R
R
R
B
B
B
B
B
E
"}
(3,1,1) = {"
E
E
E
E
E
E
B
R
R
R
R
R
R
R
R
R
R
R
B
E
"}
(4,1,1) = {"
E
E
E
E
E
E
B
R
R
R
R
R
R
R
R
R
R
R
B
E
"}
(5,1,1) = {"
E
E
E
E
E
E
B
R
R
R
A
R
R
A
R
R
R
R
B
E
"}
(6,1,1) = {"
E
E
E
E
E
E
B
R
R
R
R
R
R
R
R
R
R
R
B
E
"}
(7,1,1) = {"
E
E
E
E
E
E
B
R
R
R
R
R
R
R
R
R
R
R
R
E
"}
(8,1,1) = {"
E
E
E
E
E
E
R
R
R
R
A
R
R
A
R
R
R
R
R
E
"}
(9,1,1) = {"
E
E
E
E
E
E
R
R
R
R
R
R
R
R
R
R
R
R
R
E
"}
(10,1,1) = {"
E
E
E
E
E
E
R
R
R
R
R
R
R
R
R
R
R
R
R
E
"}
(11,1,1) = {"
E
E
E
E
E
E
R
R
R
R
R
R
R
R
R
R
R
R
B
E
"}
(12,1,1) = {"
E
E
E
E
E
E
B
R
R
R
R
R
R
R
R
R
R
R
B
E
"}
(13,1,1) = {"
E
E
E
E
E
E
B
R
R
R
R
R
R
R
R
R
R
R
B
E
"}
(14,1,1) = {"
E
E
E
E
E
E
B
R
R
R
R
R
R
R
R
R
R
R
B
E
"}
(15,1,1) = {"
E
E
E
E
E
E
B
B
B
R
R
R
R
R
R
B
B
B
B
E
"}
(16,1,1) = {"
E
E
E
E
E
E
E
E
E
E
E
E
E
E
E
E
E
E
E
E
"}
(17,1,1) = {"
E
E
E
E
E
E
E
E
E
E
E
E
E
E
E
E
E
E
E
E
"}
(18,1,1) = {"
E
E
E
E
E
E
E
E
E
E
E
E
E
E
E
E
E
E
E
E
"}
(19,1,1) = {"
E
E
E
E
E
E
E
E
E
E
E
E
E
E
E
E
E
E
E
E
"}
(20,1,1) = {"
E
E
E
E
E
E
E
E
E
E
E
E
E
E
E
E
E
E
E
E
"}
