"a" = (/turf/unsimulated/outside/sand,/area/vault/warhammergen/cadianspawn)
"s" = (/obj/effect/landmark/start/inquisitor,/turf/simulated/floor,/area/vault/warhammergen/cadianspawn)
"v" = (/obj/effect/landmark/start/commissar,/turf/simulated/floor,/area/vault/warhammergen/cadianspawn)
"y" = (/obj/effect/landmark/start/primaris_psyker,/turf/simulated/floor,/area/vault/warhammergen/cadianspawn)
"z" = (/obj/effect/landmark/start/preacher,/turf/simulated/floor,/area/vault/warhammergen/cadianspawn)
"T" = (/turf/simulated/wall/r_wall,/area/vault/warhammergen/cadianspawn)
"U" = (/obj/effect/landmark/start/IG_Cadian_Trooper,/turf/simulated/floor,/area/vault/warhammergen/cadianspawn)
"V" = (/obj/effect/landmark/start/IG_Cadian_Sergeant,/turf/simulated/floor,/area/vault/warhammergen/cadianspawn)
"W" = (/turf/simulated/floor,/area/vault/warhammergen/cadianspawn)
"Z" = (/obj/effect/landmark/start/general,/turf/simulated/floor,/area/vault/warhammergen/cadianspawn)

(1,1,1) = {"
aaaaaaaaaaaaaaaaaaaa
aTTTTTTWWWWWWTTTTTTa
aTWWWWWWWWWWWWWWWWTa
aTWWWWWWWWWWWWWWWWTa
aTWWWWWWWWWWWWWWWWTa
aTWWVWWWUWWWWWWWWWTa
aWWWWWWWWWWWWWWWWWWa
aWWWWWWWWWWWWWWWWWWa
aWWWWWWWWWUWWWWWWWWa
aWWWvWWWZWWWWWWWWWWa
aWWWWWWWWWWWWWWWWWWa
aWWWWWWWWWWUWWWWWWWa
aWWWsWWWzWWWWWWWWWWa
aWWWWWWWWWWWWWWWWWWa
aTWWWWWWWWWWWWWWWWTa
aTWWWWWWyWWWWWWWWWTa
aTWWWWWWWWWWWWWWWWTa
aTWWWWWWWWWWWWWWWWTa
aTTTTTWWWWWWWWTTTTTa
aaaaaaaaaaaaaaaaaaaa
"}
