//MAP CONVERTED BY dmm2tgm.py THIS HEADER COMMENT PREVENTS RECONVERSION, DO NOT REMOVE
"a" = (
/turf/space,
/area)
"s" = (
/obj/effect/landmark/start/inquisitor,
/turf/simulated/floor,
/area/vault/warhammergen/cadianspawn)
"v" = (
/obj/effect/landmark/start/commissar,
/turf/simulated/floor,
/area/vault/warhammergen/cadianspawn)
"z" = (
/obj/effect/landmark/start/preacher,
/turf/simulated/floor,
/area/vault/warhammergen/cadianspawn)
"T" = (
/turf/simulated/wall/r_wall,
/area/vault/warhammergen/cadianspawn)
"U" = (
/obj/effect/landmark/start/IG_Cadian_Trooper,
/turf/simulated/floor,
/area/vault/warhammergen/cadianspawn)
"V" = (
/obj/effect/landmark/start/IG_Cadian_Sergeant,
/turf/simulated/floor,
/area/vault/warhammergen/cadianspawn)
"W" = (
/turf/simulated/floor,
/area/vault/warhammergen/cadianspawn)
"Z" = (
/obj/effect/landmark/start/general,
/turf/simulated/floor,
/area/vault/warhammergen/cadianspawn)

(1,1,1) = {"
a
a
a
a
a
a
a
a
a
a
a
a
a
a
a
a
a
a
a
a
"}
(2,1,1) = {"
a
T
T
T
T
T
W
W
W
W
W
W
W
W
T
T
T
T
T
a
"}
(3,1,1) = {"
a
T
W
W
W
W
W
W
W
W
W
W
W
W
W
W
W
W
T
a
"}
(4,1,1) = {"
a
T
W
W
W
W
W
W
W
W
W
W
W
W
W
W
W
W
T
a
"}
(5,1,1) = {"
a
T
W
W
W
V
W
W
W
v
W
W
s
W
W
W
W
W
T
a
"}
(6,1,1) = {"
a
T
W
W
W
W
W
W
W
W
W
W
W
W
W
W
W
W
T
a
"}
(7,1,1) = {"
a
T
W
W
W
W
W
W
W
W
W
W
W
W
W
W
W
W
W
a
"}
(8,1,1) = {"
a
W
W
W
W
W
W
W
W
W
W
W
W
W
W
W
W
W
W
a
"}
(9,1,1) = {"
a
W
W
W
W
U
W
W
W
Z
W
W
z
W
W
W
W
W
W
a
"}
(10,1,1) = {"
a
W
W
W
W
W
W
W
W
W
W
W
W
W
W
W
W
W
W
a
"}
(11,1,1) = {"
a
W
W
W
W
W
W
W
W
W
W
W
W
W
W
W
W
W
W
a
"}
(12,1,1) = {"
a
W
W
W
W
W
W
W
W
W
W
W
W
W
W
W
W
W
W
a
"}
(13,1,1) = {"
a
W
W
W
W
W
W
W
W
W
W
W
W
W
W
W
W
W
W
a
"}
(14,1,1) = {"
a
T
W
W
W
W
W
W
W
W
W
W
W
W
W
W
W
W
W
a
"}
(15,1,1) = {"
a
T
W
W
W
W
W
W
W
W
W
W
W
W
W
W
W
W
T
a
"}
(16,1,1) = {"
a
T
W
W
W
W
W
W
W
W
W
W
W
W
W
W
W
W
T
a
"}
(17,1,1) = {"
a
T
W
W
W
W
W
W
W
W
W
W
W
W
W
W
W
W
T
a
"}
(18,1,1) = {"
a
T
W
W
W
W
W
W
W
W
W
W
W
W
W
W
W
W
T
a
"}
(19,1,1) = {"
a
T
T
T
T
T
W
W
W
W
W
W
W
W
T
T
T
T
T
a
"}
(20,1,1) = {"
a
a
a
a
a
a
a
a
a
a
a
a
a
a
a
a
a
a
a
a
"}
