"a" = (/turf/unsimulated/outside/sand,/area/warhammer/desert)
"b" = (/obj/machinery/portable_atmospherics/hydroponics/soil,/turf/unsimulated/outside/sand,/area/warhammer/desert)
"c" = (/obj/structure/table/reinforced,/obj/machinery/reagentgrinder{pixel_y = 10},/turf/simulated/floor/carpet/floor_tile,/area/warhammer/desert)
"d" = (/obj/item/weapon/bedsheet/green,/obj/structure/bed,/turf/simulated/floor/carpet/floor_tile,/area/warhammer/desert)
"e" = (/obj/machinery/biogenerator,/turf/simulated/floor/wood/floor_tile,/area/warhammer/desert)
"f" = (/obj/structure/closet/secure_closet/hydroponics,/turf/simulated/floor/wood/floor_tile,/area/warhammer/desert)
"g" = (/obj/machinery/vending/engineering,/turf/unsimulated/outside/sand,/area/warhammer/desert)
"k" = (/mob/living/simple_animal/hostile/lizard/frog,/turf/unsimulated/outside/sand,/area/warhammer/desert)
"m" = (/obj/structure/table/reinforced,/obj/machinery/chemheater,/turf/simulated/floor/carpet/floor_tile,/area/warhammer/desert)
"p" = (/obj/machinery/seed_extractor,/turf/simulated/floor/wood/floor_tile,/area/warhammer/desert)
"q" = (/obj/item/weapon/pitchfork,/turf/unsimulated/outside/sand,/area/warhammer/desert)
"t" = (/obj/item/stack/sheet/metal/bigstack,/turf/simulated/floor/carpet/floor_tile,/area/warhammer/desert)
"u" = (/obj/structure/sink/puddle,/turf/unsimulated/outside/sand,/area/warhammer/desert)
"w" = (/obj/machinery/vending/hydronutrients,/turf/simulated/floor/wood/floor_tile,/area/warhammer/desert)
"x" = (/obj/machinery/chem_master,/turf/simulated/floor/carpet/floor_tile,/area/warhammer/desert)
"z" = (/obj/road_node,/turf/unsimulated/outside/sand,/area/warhammer/desert)
"A" = (/obj/machinery/vending/engivend,/turf/unsimulated/outside/sand,/area/warhammer/desert)
"B" = (/turf/simulated/floor/carpet/floor_tile,/area/warhammer/desert)
"C" = (/obj/machinery/chem_dispenser/mapping,/turf/simulated/floor/carpet/floor_tile,/area/warhammer/desert)
"D" = (/obj/machinery/vending/hydroseeds,/turf/simulated/floor/wood/floor_tile,/area/warhammer/desert)
"E" = (/obj/item/weapon/storage/box/beakers,/turf/simulated/floor/carpet/floor_tile,/area/warhammer/desert)
"F" = (/obj/item/weapon/pickaxe/shovel,/turf/unsimulated/outside/sand,/area/warhammer/desert)
"G" = (/obj/machinery/door/mineral/wood,/turf/simulated/floor/wood/floor_tile,/area/warhammer/desert)
"J" = (/turf/simulated/floor/wood/floor_tile,/area/warhammer/desert)
"O" = (/obj/item/weapon/gun/projectile/shotgun/doublebarrel/sawnoff,/turf/simulated/floor/carpet/floor_tile,/area/warhammer/desert)
"R" = (/obj/item/weapon/storage/box/buckshotshells,/turf/simulated/floor/carpet/floor_tile,/area/warhammer/desert)
"T" = (/mob/living/simple_animal/hostile/lizard,/turf/unsimulated/outside/sand,/area/warhammer/desert)
"U" = (/turf/simulated/wall/r_wall,/area/warhammer/desert)
"W" = (/obj/machinery/apiary/wild,/turf/unsimulated/outside/sand,/area/warhammer/desert)
"Y" = (/obj/item/ammo_storage/box/piles/buckshotpile/max_pile,/turf/simulated/floor/carpet/floor_tile,/area/warhammer/desert)

(1,1,1) = {"
UUUUUUUUUU
UfwDUxCYOU
UJJJUEBBBU
UJJJGBEBdU
UpJeUcmRtU
UUGUUUUUUU
uaakuugAWa
aaaaaaaaaa
abbbaabbba
aaaaakaaaa
abbbaabbba
abbbaabbba
aaTaaqaaaa
abbbaabbba
abbbaabbba
aaaaFaaaaa
abbbaabbba
abbbaabbba
aaaaazaaaa
aaaaaaaaaa
"}
